#################
#.......#.......#
#.##.##.#.##.##.#
#...............#
#.##.#.###.#.##.#
#....#..#..#....#
####.##.#.##.####
...#.#.....#.#...
####.#.###.#.####
......#...#......
####...###...####
...#.#.....#.#...
####.#.###.#.####
#.......#.......#
#.##.##.#.##.##.#
#..#....@....#..#
## # # ### # # ##
#....#..#..#....#
#.#####.#.#####.#
#...............#
#################