#################
#.......#.......#
#.##.##.#.##.##.#
#...............#
#.##.#.###.#.##.#
#....#..#..#....#
####.## # ##.####
   #.#     #.#...
####.  = =  .####
!   . =1  = .   !
####.  ===  .####
   #.#     #.#...
####.# ### #.####
#.......#.......#
#.##.##.#.##.##.#
#..#....@....#..#
##.#.#.###.#.#.##
#....#..#..#....#
#.#####.#.#####.#
#...............#
#################